EA ./textures/street_lamp2.png
NO ./textures/street_lamp2.png
SO ./textures/street_lamp2.png
WE ./textures/street_lamp2.png

C 0,0,0
F 0,0,0

111111111111111111111
1L1000001000020002001
141010121011111110001
100010102010020010001
111110121111101011101
100200101000121002001
121111121011101111111
101200001010100200101
121011111010111110101
101010201010102010121
101110101010101010101
102000101010201010001
111111101011111011101
120020101020100010201
101110101110101110111
101020100000100010101
101011111111111010101
1N0010200020000010001
101010111011111111101
1Z1002001000020000031
111111111111111111111
