EA ./path_to_the_east_texture
NO ./path_to_the_north_texture
SO ./path_to_the_south_texture
WE ./path_to_the_west_texture

C 225,30,0
F 225,30,0

1111111111             11111
1000000001              10001
1000S00001               1001
1000000001              1001
1000000001             10001
1000000001111111111111110001
1000000000000000000000000001
11111111111111111111110000001
                      10000001
                       10000001
1111111111111111111111100000001
11111100000000000000000000110001
11111001111111111000001111110001
1111001111111111110000011110001
1110011111111111111000000000001
1100011111111111111111111111111
1100111
1100111
1100111
1000001
1000001
1000001
1000001
1111111
