
EA ./textures/window.png
NO ./textures/window.png
SO ./textures/window.png
WE ./textures/window.png

C 225,30,0
F 225,30,0

        1111111111111111111111111
        1000000000110000000000001
        1011000001110000000000001
        1001000000000000000000001
111111111011000001110000000000001
10000000001100000111D111111111111
11110111111111011100000010001
1111D111111111011101010010001
11000000110101D11100000010001
10000000P00000001100000010001
10000000E00000001101010010001
1100000111010101111101111000111
11110111 1110101 101111010001
11111111 1111111 111111111111
