
EA ./textures/wooden_wall_no_window.png
NO ./textures/wooden_wall.png
SO ./textures/wooden_wall.png
WE ./textures/wooden_wall_no_window.png

C 005,30,0
F 005,30,0

        1111111111111111111111111
        1000000003110000000000001
        1011300001110000000L00001
        1001000000000000000000001
111111111011000001110000000000001
10000000001100000111D111111111111
11110111111111011100000010001
1111D111111111011101010010001
11000200110101D11100000010001
10Z00202002030001100000010001
10000200W00003001101010010001
1102020111010101111101111000111
11110111 1110101 101111010001
11111111 1111111 111111111111
