EA ./textures/wooden_wall_no_window.png
NO ./textures/wooden_wall.png
SO ./textures/wooden_wall.png
WE ./textures/wooden_wall_no_window.png

C 255 	 	 , 	 	0 	 	 ,	 	 0
F 0 	 	 , 	 	0 	 	 	 	 	,    		255

11111111111111111
10000000000000001
10000000000000001
10000000000000001
10000000000000001
10000000000000001
10000000N00000001
10000000000000001
10000000000000001
10000000000000001
10000000000030001
10000000000000001
11111011111111111
    101
11111011111111111
10000000000000001
10000000002000001
10000000000000001
10200000000200001
10000000000000001
10000000000200001
10200000000000001
10000000400200001
10000000000000001
1000000Z000200001
1020000000L000001
11111111111111111
