EA ./textures/wooden_wall_no_window.png
NO ./textures/wooden_wall.png
SO ./textures/wooden_wall.png
WE ./textures/wooden_wall_no_window.png

C 225,30,0
F 225,30,0

       11111111111111111111111111111
       10000000010000000000000010001
       1000S00001000000000000001001
       100000000D00000000000001001
       1000000001000000000000010001
       1000000001111111111111110001
       1000000000000000000Z00111111
11111111111111111111110000001
                      10000001
                       10000001
1111111111111111111111100000001
11111100000000000000000000110001
11111001111111111000001111110001
1111001111111111110000011110001
1110011111111111111000000000001
1100011111111111111111111111111
1100111
1100111
1100111
1000001
1004001
100L001
1000001
1111111
